1111111111111
100100C0000C1
1C00011111001
100P11E000001
1111111111111