111111111111111111111111111111111111111111111111111111111111
1C0000000000001000000000000000000000000000000000000000000001
1000000000000000000C0000000000000000000000000000000000000001
1101110000111100C0000000000000000000000000000011100000000001
1E0000000011110111000000000000000000000000000011000000000001
1111111100011101P0000000000000000000000000000011001100000001
100000000000010111000000000000000000000000000000000000000001
10C000000000010000000000000000000000000000000000000000000001
1101110000111100000C0000000000000000000000000000000000000001
10000000000C000000000000000000000000000000000000000000000001
10000000000C000000000000000000000000000000000000000000000001
10000000000C000000000000000000000000000000000000000000000001
10000000000C000000000000000000000000000000000000000000000001
10000000000C000000000000000000000011110000000000000000000001
10000000000C000000000000000000000000000000000000000000000001
10000000000C000000000000000000000000000000000000000000000001
10000000000C000000000000000000000000000000000000000000000001
100000000001000000000000000000000000000000000000000000000001
100000001111100000000000000000000000000000000000000000000001
100000000011111000000000000000000000000000000000000000000001
10000000000C001100000000000000000000000000000000000000000001
10000000000C001100000000000000000000000000000000000000000001
100000000000001100000000000000000000000000000000000000000001
100000000000001100000000000000000000000000000000000000000001
100000000000001100000000000000000000000000000000000000000001
100000000000001100000000000000000000000000000000000000000001
100000000000001100000000000000000000000000000000000000000001
100000000000001100000000000000000000000000000000000000000001
100000000000001100000000000000000000000000000000000000000001
100000000000001100000000000000000000000000000000000000000001
100000000000001100000000000000000000000000000000000000000001
100000000000001100000000000000000000000000000000000000000001
100000000000001100000000000000000000000000000000000000000001
100000000000001100000000000000000000000000000000000000000001
100000000000001100000000000000000000000000000000000000000001
100000000000001100000000000000000000000000000000000000000001
100000000000001100000000000000000000000000000000000000000001
100000000000001100000000000000000000000000000000000000000001
100000000000001100000000000000000000000000000000000000000001
100000000000001100000000000000000000000000000000000000000001
100000000000001100000000000000000000000000000000000000000001
100000000000001100000000000000000000000000000000000000000001
111111111111111111111111111111111111111111111111111111111111
