1111111111111
10001000000C1
1000100000001
1P000000E0001
1111111111111